|----------------------|
|......................|
|......................|
|......................|
|......................|
|......................|
|-----------------D----|
|-----------------D----|
|......................|
|......................|
|......................|
|......................|
|......................|
|----E-----------------|